MAP
..######..
###_____##
#___###__#
#_#_###__#
#___###__#
###______#
#____#__##
#_#__#___#
####__####
...####...
ENTITIES
..######..
###.K..###
#........#
#.O......#
#.......O#
####.O####
...####...