MAP
..#######..
###______##
#_________#
#_____##__#
#_#____#__#
#____###__#
#_________#
###_______#
#_________#
#____#___##
#_#__#____#
####___####
...####....
ENTITIES
..#######..
###____K_##
#_________#
#O____##__#
#_#___O#__#
#____###__#
#_________#
###_______#
#_________#
#____#___##
#_#__#____#
####_O_####
...####...