MAP
###########
#_________#
#_#_____#_#
#_________#
#_#_____#_#
#_________#
#_#_____#_#
#_________#
#_#_____#_#
#_________#
#_#_____#_#
#_________#
#_#_____#_#
#_________#
#_#_____#_#
#_________#
###########
ENTITIES
###########
#____K____#
#_#_____#_#
#_________#
#_#_____#_#
#_______O_#
#_#_____#_#
#_________#
#_#_____#_#
#____O____#
#_#_____#_#
#_________#
#_#_____#_#
#_________#
#_#O____#_#
#_________#
###########