# Map generated by ChatGPT

MAP
######################
#_______#________#___#
#_______#___#____##__#
#___#___#____________#
#___#_______#####____#
#___#_______#________#
#_______#_____###_#__#
#_______#_______#____#
#_______#_________#__#
######################
ENTITIES
######################
#___O__#________#___#
#_______#___#_O__##__#
#___#___#______OO____#
#K__#___O___#####____#
#___#___O___#______O_#
#_______#_____###_#__#
#_______#___O___#___O#
#___O___#_________#__#
######################