# Map generated by ChatGPT

MAP
##########
#________#
#__#__#__#
###__###_#
#________#
#________#
###_##_###
#_______#.
#________#
##########
ENTITIES
##########
#________#
#__#__#__#
###__###_#
#________#
#________#
###_##_###
#_______#.
#________#
##########