MAP
...#####...
...#___#...
...#___#...
####___####
#_________#
#_________#
#_________#
####___####
...#___#...
...#___#...
...#####...
ENTITIES
...#####...
...#_O_#...
...#___#...
####___####
#_________#
#O___K___O#
#_________#
####___####
...#___#...
...#_O_#...
...#####...