MAP
############
#____##____#
#_##____##_#
#_##___###_#
#___#_###__#
##___###__##
##_####___##
#___##_#___#
#__#_#__#__#
#_#______#_#
#____##____#
############
ENTITIES
############
#____##__O_#
#_##__O_##_#
#_##_O_###_#
#_OO#_###_O#
##O__###__##
##_####___##
#___##_#___#
#__#_#_O#__#
#_#___O__#_#
#K___##_O__#
############