MAP
..######..
.##____##.
##__#___##
#___#____#
#___#____#
#___###__#
#________#
##______##
.##____##.
..######..
ENTITIES
..######..
.##_K__##.
##O_#__O##
#___#____#
#O__#___O#
#___###__#
#O______O#
##______##
.##__O_##.
..######..