MAP
###############
#_______###___#
#____#___###__#
#_____#___#___#
#_##___#______#
#__#____#___#_#
#________#____#
#____#________#
#____##____#__#
#_#___##____#_#
#______##_____#
#___#_________#
#____#____#___#
#_____________#
###############
ENTITIES
###############
#K______###O__#
#____#_O_###__#
#_____#___#_O_#
#_##__O#______#
#__#_O__#___#_#
#_______O#__O_#
#_O__#________#
#____##_O__#__#
#_#___##___O#_#
#___O__##___O_#
#___#__O__O___#
#_O__#____#__O#
#__O__________#
###############